###################
#.................#
#.#.###.#.#.###.#.#
#.#.#...#.#...#.#.#
#.#.###.#.#.###.#.#
#.................#
#.#.#.### ###.#.#.#
#.................#
#.#.###.#.#.###.#.#
#.#.#...#.#...#.#.#
#.#.###.#.#.###.#.#
#.................#
###################